111111111111111111111111111111111111111
100000000000000000000000000000000000001
100000000000000000000000000000000000001
1000000000000000000000000E0000000000001
100000000000000000000000000000000000001
10000C000000000000000000000000000000001
100000000000001000000000000000000000001
100000000000001000000000000000000000001
100000000111111111111000000000000000001
100000000000001000000000000000000000001
1000000000000010P0000000000000000000001
100000000000001000000000000000000000001
100000000000001000000000000000000000001
1000C0000000001000000000000000000000001
100000000000000000000000000000000000001
100000000000000000000000000C00000000001
100000000000000000000000000000000000001
100000000000000000000000000000000000001
100000000000000000000000000000000000001
111111111111111111111111111111111111111