111111111111111111111
100000000000000000001
10000P00000000C000001
100000000000000000001
100000C00000000000E01
100000000000000C00001
111111111111111111111
