111111111111111111111
10001C00000001C000001
100010100000011111101
1000001C00000C1000001
100111111110001000001
1001C0100010001E00001
100000101110001110001
1001111110000010C0001
100100010001111000001
10010P010001001111101
100000010E00000000001
111111111111111111111