111111111111111111111
100000000000000000001
10000P00000000C000001
100000011100000011111
100000C10100000000E01
100000011100000C10000
111111111111111111111
