111111111111111111111
100010000000010000001
100010100000011111101
100000100000001000000
100111111110001000001
100100100010001E00001
100000101110001110001
100111111000001000001
100100010001111000001
10010P010001001111101
100000010000000000001
111111111111111111111